16 16
XXXXXXXXXXXXXXXX
X*............*X
X.X.XXX..XXX.X.X
X.X..........X.X
X.X.XXXXXXXX.X.X
X.X..........X.X
X.*.XXX  XXX.*.X
X.X.X      X.X.X
X.X.X      X.X.X
X.*.XXXXXXXX.*.X
X.X..........X.X
X.X.XXXXXXXX.X.X
X.X..........X.X
X.X.XXX..XXX.X.X
X*............*X
XXXXXXXXXXXXXXXX
